##########
#......#.#
#.####.#.#
#....#...#
#T##.###.#
#..#.....#
##########
